PROGRAM DECLIST ZERO STRINGFORM DIGITSEQ LETTERS DIGIT NONZERO SIGN NO STMTLIST TERMID CONDFOR VAR OPERATORFOR LOGICAL SIMPLERELATIONSTMT CONDIF ASSIGNSTMT FORSTMT IFSTMT STRING DISPLAYEXPRESSION OUTPUTSTMT INPUTSTMT SELECTOR RELATION OPERATOR ACCESSARRAYSTMT BOOLEAN TERM SEPARATORORRELATION EXPRESSION IOSTMT SIMPLESTMT CONDSTMT STMT DLIST FLOAT FLOATARRAY INTEGER DECLARATION ARRAYDECLWITHSIZE ARRAYDECLWITHVALUES AN DLIST IDDECLARATION ARRAYDECL TYPE IDENTIFIER LETTER ALPHANUMERIC
main { } , \n ! @ # $ % ^ & _ / . ? : \ | 0 numbers = true " false [ ... ] _ ( ) ; + - / * % < and or <= == >= > display userInput check fail loop A B C D E F G H I J K L M N O P Q R S T U V W X Y Z a b c d e f g h i j k l m n o p q r s t u v w x y z 0 1 2 3 4 5 6 7 8 9
PROGRAM - main { DECLIST STMTLIST }
DECLIST - DLIST | DLIST DLIST
DLIST - DECLARATION | DECLARATION , DLIST
DECLARATION - IDDECLARATION | ARRAYDECL
IDDECLARATION - TYPE IDENTIFIER
TYPE - number
TYPE - truth
IDENTIFIER - LETTER AN
LETTER - A | B | C | D | E | F | G | H | I | J | K | L | M | N | O | P | Q | R | S | T | U | V | W | X | Y | Z | a | b | c | d | e | f | g | h | i | j | k | l | m | n | o | p | q | r | s | t | u | v | w | x | y | z
AN - LETTER | ZERO | NONZERO
ZERO - 0
NONZERO - 1 | 2 | 3 | 4 | 5 | 6 | 7 | 8 | 9
ARRAYDECL - numbers IDENTIFIER = [ ... INTEGER ] | numbers IDENTIFIER = [ FLOATARRAY ]
FLOATARRAY - FLOAT | FLOAT , FLOATARRAY
STMTLIST - STMT _ | STMT _ STMTLIST
STMT - SIMPLESTMT | CONDSTMT
SIMPLESTMT - ASSIGNSTMT | IOSTMT
ASSIGNSTMT - IDENTIFIER = EXPRESSION
EXPRESSION - TERM | EXPRESSION SEPARATORORRELATION TERM
TERM - ( EXPRESSION ) | IDENTIFIER | FLOAT | BOOLEAN | ACCESSARRAYSTMT
OPERATORORRELATION - OPERATOR | RELATION
OPERATOR - + | - | * | / | % | < | <= | == | >= | >
ACCESSARRAYSTMT - IDENTIFIER [ SELECTOR ]
SELECTOR - IDENTIFIER | INTEGER
IOSTMT - display ( DISPLAYEXPRESSION ) | userInput ( IDENTIFIER )
DISPLAYEXPRESSION - IDENTIFIER | STRING
CONDSTMT - IFSTMT | FORSTMT
IFSTMT - check ( CONDIF ) { STMTLIST } | check ( CONDIF ) { STMTLIST } fail { STMTLIST }
FORSTMT - loop ( CONDFOR ) { STMTLIST }
CONDIF - TERMID RELATION TERMID | SIMPLERELATIONSTMT LOGICAL SIMPLERELATIONSTMT
SIMPLERELATIONSTMT - TERMID RELATION TERMID | BOOLEAN
LOGICAL - and | or
CONDFOR - IDENTIFIER ; IDENTIFIER RELATION VAR ; IDENTIFIER OPERATORFOR INTEGER
OPERATORFOR - + | -
VAR - IDENTIFIER | FLOAT
INTEGER - ZERO | NO | SIGN NO
NO - NONZERO | NONZERO DIGITSEQ
DIGITSEQ - DIGIT | DIGIT DIGITSEQ
DIGIT - ZERO | NONZERO
SIGN - - | +
FLOAT - INTEGER | INTEGER , NO
BOOLEAN - true | false
STRING - " STRINGFORM "
STRINGFORM - LETTERS | DIGITSSEQ | SPECIALCHAR | LETTERS STRINGFORM | DIGITSEQ STRINGFORM | SPECIALCHAR STRINGFORM
LETTERS - LETTER LETTERS | LETTER
SPECIALCHAR - + | - | ! | @ | # | $ | % | ^ | & | * | ( | ) | _ | [ | { | ] | ] | \ | ; | : | , | < | . | > | / | ?